%..*##%...%#.^
##.#%#..#*.#.#
...#.#.###.#..
.##*.#...#.##.
...#.#*#.#....
##.#.###.#####
...#..........
.############.
....#...#...#.
..#.#.#.#.#.#.
@%#...#...#...
