......#...#...
.####...#.#.#.
....###.#...#.
##.#...######.
...#.#........
.###..#.######
#.....#..#....
..######.#.##.
.#.......#.#..
.#.#######.##@
&#...........#