####*#.###..*#
.....#.....#.#
.###.#.###.#%#
.#...#...#....
.#.#####..#.#.
.#.#....#.#.#*
.#.#.##*#.#.*#
.#.#.####.#.#.
.#.#.##...#.#.
.#......##...&
.@#%%%%...####