####.#.###...#
.....#.....#.#
.###.#.###.#.#
.#...#...#....
.#.#####..#.#.
.#.#....#.#.#.
.#.#.##.#.#..#
.#.#.####.#.#.
.#.#.##...#.#.
.#......##...&
.@#####...####