....##.....#.&
##.#.#..#..#.#
...#.#.###.#..
.##..#...#.##.
...#.#.#.#....
##.#.###.#####
...#..........
.############.
....#...#...#.
..#.#.#.#.#.#.
@.#...#...#...