......#...#...
.####...#.#.#.
...%###*#...#.
##.#...######.
...#.#........
*###.*#.######
%....%#..#....
..######.#.##.
.#.......#.#*.
.#.#######.##@
&#...........#